case GameTurn: "GAME_TURN";
case MyNumPeople: "MY_NUM_PEOPLE";
case BluePeople: "BLUE_PEOPLE";
case RedPeople: "RED_PEOPLE";
case YellowPeople: "YELLOW_PEOPLE";
case GreenPeople: "GREEN_PEOPLE";
case MyNumKilledByHuman: "MY_NUM_KILLED_BY_HUMAN";
case RedKilledByHuman: "RED_KILLED_BY_HUMAN";
case YellowKilledByHuman: "YELLOW_KILLED_BY_HUMAN";
case GreenKilledByHuman: "GREEN_KILLED_BY_HUMAN";
case WildPeople: "WILD_PEOPLE";
case BlueMana: "BLUE_MANA";
case RedMana: "RED_MANA";
case YellowMana: "YELLOW_MANA";
case GreenMana: "GREEN_MANA";
case AttrExpansion: "ATTR_EXPANSION";
case AttrPrefSpyTrains: "ATTR_PREF_SPY_TRAINS";
case AttrPrefReligiousTrains: "ATTR_PREF_RELIGIOUS_TRAINS";
case AttrPrefWarriorTrains: "ATTR_PREF_WARRIOR_TRAINS";
case AttrPrefFirewarriorTrains: "ATTR_PREF_FIREWARRIOR_TRAINS";
case AttrPrefSpyPeople: "ATTR_PREF_SPY_PEOPLE";
case AttrPrefReligiousPeople: "ATTR_PREF_RELIGIOUS_PEOPLE";
case AttrPrefWarriorPeople: "ATTR_PREF_WARRIOR_PEOPLE";
case AttrPrefFirewarriorPeople: "ATTR_PREF_FIREWARRIOR_PEOPLE";
case AttrMaxBuildingsOnGo: "ATTR_MAX_BUILDINGS_ON_GO";
case AttrHousePercentage: "ATTR_HOUSE_PERCENTAGE";
case AttrAwayBrave: "ATTR_AWAY_BRAVE";
case AttrAwayWarrior: "ATTR_AWAY_WARRIOR";
case AttrAwayReligious: "ATTR_AWAY_RELIGIOUS";
case AttrDefenseRadIncr: "ATTR_DEFENSE_RAD_INCR";
case AttrMaxDefensiveActions: "ATTR_MAX_DEFENSIVE_ACTIONS";
case AttrAwaySpy: "ATTR_AWAY_SPY";
case AttrAwayFirewarrior: "ATTR_AWAY_FIREWARRIOR";
case AttrAttackPercentage: "ATTR_ATTACK_PERCENTAGE";
case AttrAwayShaman: "ATTR_AWAY_SHAMAN";
case AttrPeoplePerBoat: "ATTR_PEOPLE_PER_BOAT";
case AttrPeoplePerBallon: "ATTR_PEOPLE_PER_BALLON";
case AttrDontUseBoats: "ATTR_DONT_USE_BOATS";
case AttrMaxSpyAttacks: "ATTR_MAX_SPY_ATTACKS";
case AttrEnemySpyMaxStand: "ATTR_ENEMY_SPY_MAX_STAND";
case AttrMaxAttacks: "ATTR_MAX_ATTACKS";
case AttrEmptyAtWaypoing: "ATTR_EMPTY_AT_WAYPOING";
case AttrSpyCheckFrequency: "ATTR_SPY_CHECK_FREQUENCY";
case AttrRetreatValue: "ATTR_RETREAT_VALUE";
case AttrBaseUnderAttackRetreat: "ATTR_BASE_UNDER_ATTACK_RETREAT";
case AttrRandomBuildSide: "ATTR_RANDOM_BUILD_SIDE";
case AttrUsePreacherForDefense: "ATTR_USE_PREACHER_FOR_DEFENSE";
case AttrShamenBlast: "ATTR_SHAMEN_BLAST";
case AttrMaxTrainAtOnce: "ATTR_MAX_TRAIN_AT_ONCE";
case AttrGroupOption: "ATTR_GROUP_OPTION";
case AttrPrefBoatHuts: "ATTR_PREF_BOAT_HUTS";
case AttrPrefBallonHuts: "ATTR_PREF_BALLON_HUTS";
case AttrPrefBoatDrivers: "ATTR_PREF_BOAT_DRIVERS";
case AttrPrefBallonDrivers: "ATTR_PREF_BALLON_DRIVERS";
case AttrFightStopDistance: "ATTR_FIGHT_STOP_DISTANCE";
case AttrSpyDiscoverChange: "ATTR_SPY_DISCOVER_CHANGE";
case AttrCountPreachDamage: "ATTR_COUNT_PREACH_DAMAGE";
case AttrDontGroupAtDt: "ATTR_DONT_GROUP_AT_DT";
case AttrSpellDelay: "ATTR_SPELL_DELAY";
case AttrDontDeleteUselessBoatHouse: "ATTR_DONT_DELETE_USELESS_BOAT_HOUSE";
case AttrBoatHouseBroken: "ATTR_BOAT_HOUSE_BROKEN";
case AttrDontAutoTrainPreachers: "ATTR_DONT_AUTO_TRAIN_PREACHERS";
case AttrSpare6: "ATTR_SPARE_6";
case MyMana: "MY_MANA";
case MySpellBurnCost: "MY_SPELL_BURN_COST";
case MySpellBlastCost: "MY_SPELL_BLAST_COST";
case MySpellLightningCost: "MY_SPELL_LIGHTNING_COST";
case MySpellTornadoCost: "MY_SPELL_TORNADO_COST";
case MySpellInsectPlagueCost: "MY_SPELL_INSECT_PLAGUE_COST";
case MySpellInvisibilityCost: "MY_SPELL_INVISIBILITY_COST";
case MySpellHypnotismCost: "MY_SPELL_HYPNOTISM_COST";
case MySpellFirestormCost: "MY_SPELL_FIRESTORM_COST";
case MySpellGhostArmyCost: "MY_SPELL_GHOST_ARMY_COST";
case MySpellErosionCost: "MY_SPELL_EROSION_COST";
case MySpellSwampCost: "MY_SPELL_SWAMP_COST";
case MySpellLandBridgeCost: "MY_SPELL_LAND_BRIDGE_COST";
case MySpellAngelOfDeadCost: "MY_SPELL_ANGEL_OF_DEAD_COST";
case MySpellEarthquakeCost: "MY_SPELL_EARTHQUAKE_COST";
case MySpellFlattenCost: "MY_SPELL_FLATTEN_COST";
case MySpellVolcanoCost: "MY_SPELL_VOLCANO_COST";
case MySpellWrathOfGodCost: "MY_SPELL_WRATH_OF_GOD_COST";
case MyBuildingSmallHut: "MY_BUILDING_SMALL_HUT";
case MyBuildingMediumHut: "MY_BUILDING_MEDIUM_HUT";
case MyBuildingLargeHut: "MY_BUILDING_LARGE_HUT";
case MyBuildingDrumTower: "MY_BUILDING_DRUM_TOWER";
case MyBuildingTemple: "MY_BUILDING_TEMPLE";
case MyBuildingSpyTrain: "MY_BUILDING_SPY_TRAIN";
case MyBuildingWarriorTrain: "MY_BUILDING_WARRIOR_TRAIN";
case MyBuildingFirewarriorTrain: "MY_BUILDING_FIREWARRIOR_TRAIN";
case MyBuildingReconversion: "MY_BUILDING_RECONVERSION";
case MyBuildingWallPiece: "MY_BUILDING_WALL_PIECE";
case MyBuildingGate: "MY_BUILDING_GATE";
case MyBuildingCurrOeSlot: "MY_BUILDING_CURR_OE_SLOT";
case MyBuildingBoatHut: "MY_BUILDING_BOAT_HUT";
case MyBuildingBoatHut2: "MY_BUILDING_BOAT_HUT_2";
case MyBuildingAirshipHut: "MY_BUILDING_AIRSHIP_HUT";
case MyBuildingAirshipHut2: "MY_BUILDING_AIRSHIP_HUT_2";
case BlueBuildingSmallHut: "BLUE_BUILDING_SMALL_HUT";
case BlueBuildingMediumHut: "BLUE_BUILDING_MEDIUM_HUT";
case BlueBuildingLargeHut: "BLUE_BUILDING_LARGE_HUT";
case BlueBuildingDrumTower: "BLUE_BUILDING_DRUM_TOWER";
case BlueBuildingTemple: "BLUE_BUILDING_TEMPLE";
case BlueBuildingSpyTrain: "BLUE_BUILDING_SPY_TRAIN";
case BlueBuildingWarriorTrain: "BLUE_BUILDING_WARRIOR_TRAIN";
case BlueBuildingFirewarriorTrain: "BLUE_BUILDING_FIREWARRIOR_TRAIN";
case BlueBuildingReconversion: "BLUE_BUILDING_RECONVERSION";
case BlueBuildingWallPiece: "BLUE_BUILDING_WALL_PIECE";
case BlueBuildingGate: "BLUE_BUILDING_GATE";
case BlueBuildingCurrOeSlot: "BLUE_BUILDING_CURR_OE_SLOT";
case BlueBuildingBoatHut: "BLUE_BUILDING_BOAT_HUT";
case BlueBuildingBoatHut2: "BLUE_BUILDING_BOAT_HUT_2";
case BlueBuildingAirshipHut: "BLUE_BUILDING_AIRSHIP_HUT";
case BlueBuildingAirshipHut2: "BLUE_BUILDING_AIRSHIP_HUT_2";
case RedBuildingSmallHut: "RED_BUILDING_SMALL_HUT";
case RedBuildingMediumHut: "RED_BUILDING_MEDIUM_HUT";
case RedBuildingLargeHut: "RED_BUILDING_LARGE_HUT";
case RedBuildingDrumTower: "RED_BUILDING_DRUM_TOWER";
case RedBuildingTemple: "RED_BUILDING_TEMPLE";
case RedBuildingSpyTrain: "RED_BUILDING_SPY_TRAIN";
case RedBuildingWarriorTrain: "RED_BUILDING_WARRIOR_TRAIN";
case RedBuildingFirewarriorTrain: "RED_BUILDING_FIREWARRIOR_TRAIN";
case RedBuildingReconversion: "RED_BUILDING_RECONVERSION";
case RedBuildingWallPiece: "RED_BUILDING_WALL_PIECE";
case RedBuildingGate: "RED_BUILDING_GATE";
case RedBuildingCurrOeSlot: "RED_BUILDING_CURR_OE_SLOT";
case RedBuildingBoatHut: "RED_BUILDING_BOAT_HUT";
case RedBuildingBoatHut2: "RED_BUILDING_BOAT_HUT_2";
case RedBuildingAirshipHut: "RED_BUILDING_AIRSHIP_HUT";
case RedBuildingAirshipHut2: "RED_BUILDING_AIRSHIP_HUT_2";
case YellowBuildingSmallHut: "YELLOW_BUILDING_SMALL_HUT";
case YellowBuildingMediumHut: "YELLOW_BUILDING_MEDIUM_HUT";
case YellowBuildingLargeHut: "YELLOW_BUILDING_LARGE_HUT";
case YellowBuildingDrumTower: "YELLOW_BUILDING_DRUM_TOWER";
case YellowBuildingTemple: "YELLOW_BUILDING_TEMPLE";
case YellowBuildingSpyTrain: "YELLOW_BUILDING_SPY_TRAIN";
case YellowBuildingWarriorTrain: "YELLOW_BUILDING_WARRIOR_TRAIN";
case YellowBuildingFirewarriorTrain: "YELLOW_BUILDING_FIREWARRIOR_TRAIN";
case YellowBuildingReconversion: "YELLOW_BUILDING_RECONVERSION";
case YellowBuildingWallPiece: "YELLOW_BUILDING_WALL_PIECE";
case YellowBuildingGate: "YELLOW_BUILDING_GATE";
case YellowBuildingCurrOeSlot: "YELLOW_BUILDING_CURR_OE_SLOT";
case YellowBuildingBoatHut: "YELLOW_BUILDING_BOAT_HUT";
case YellowBuildingBoatHut2: "YELLOW_BUILDING_BOAT_HUT_2";
case YellowBuildingAirshipHut: "YELLOW_BUILDING_AIRSHIP_HUT";
case YellowBuildingAirshipHut2: "YELLOW_BUILDING_AIRSHIP_HUT_2";
case GreenBuildingSmallHut: "GREEN_BUILDING_SMALL_HUT";
case GreenBuildingMediumHut: "GREEN_BUILDING_MEDIUM_HUT";
case GreenBuildingLargeHut: "GREEN_BUILDING_LARGE_HUT";
case GreenBuildingDrumTower: "GREEN_BUILDING_DRUM_TOWER";
case GreenBuildingTemple: "GREEN_BUILDING_TEMPLE";
case GreenBuildingSpyTrain: "GREEN_BUILDING_SPY_TRAIN";
case GreenBuildingWarriorTrain: "GREEN_BUILDING_WARRIOR_TRAIN";
case GreenBuildingFirewarriorTrain: "GREEN_BUILDING_FIREWARRIOR_TRAIN";
case GreenBuildingReconversion: "GREEN_BUILDING_RECONVERSION";
case GreenBuildingWallPiece: "GREEN_BUILDING_WALL_PIECE";
case GreenBuildingGate: "GREEN_BUILDING_GATE";
case GreenBuildingCurrOeSlot: "GREEN_BUILDING_CURR_OE_SLOT";
case GreenBuildingBoatHut: "GREEN_BUILDING_BOAT_HUT";
case GreenBuildingBoatHut2: "GREEN_BUILDING_BOAT_HUT_2";
case GreenBuildingAirshipHut: "GREEN_BUILDING_AIRSHIP_HUT";
case GreenBuildingAirshipHut2: "GREEN_BUILDING_AIRSHIP_HUT_2";
case MyPersonBrave: "MY_PERSON_BRAVE";
case MyPersonWarrior: "MY_PERSON_WARRIOR";
case MyPersonReligious: "MY_PERSON_RELIGIOUS";
case MyPersonSpy: "MY_PERSON_SPY";
case MyPersonFirewarrior: "MY_PERSON_FIREWARRIOR";
case MyPersonShaman: "MY_PERSON_SHAMAN";
case BluePersonBrave: "BLUE_PERSON_BRAVE";
case BluePersonWarrior: "BLUE_PERSON_WARRIOR";
case BluePersonReligious: "BLUE_PERSON_RELIGIOUS";
case BluePersonSpy: "BLUE_PERSON_SPY";
case BluePersonFirewarrior: "BLUE_PERSON_FIREWARRIOR";
case BluePersonShaman: "BLUE_PERSON_SHAMAN";
case RedPersonBrave: "RED_PERSON_BRAVE";
case RedPersonWarrior: "RED_PERSON_WARRIOR";
case RedPersonReligious: "RED_PERSON_RELIGIOUS";
case RedPersonSpy: "RED_PERSON_SPY";
case RedPersonFirewarrior: "RED_PERSON_FIREWARRIOR";
case RedPersonShaman: "RED_PERSON_SHAMAN";
case YellowPersonBrave: "YELLOW_PERSON_BRAVE";
case YellowPersonWarrior: "YELLOW_PERSON_WARRIOR";
case YellowPersonReligious: "YELLOW_PERSON_RELIGIOUS";
case YellowPersonSpy: "YELLOW_PERSON_SPY";
case YellowPersonFirewarrior: "YELLOW_PERSON_FIREWARRIOR";
case YellowPersonShaman: "YELLOW_PERSON_SHAMAN";
case GreenPersonBrave: "GREEN_PERSON_BRAVE";
case GreenPersonWarrior: "GREEN_PERSON_WARRIOR";
case GreenPersonReligious: "GREEN_PERSON_RELIGIOUS";
case GreenPersonSpy: "GREEN_PERSON_SPY";
case GreenPersonFirewarrior: "GREEN_PERSON_FIREWARRIOR";
case GreenPersonShaman: "GREEN_PERSON_SHAMAN";
case BlueKilledByMe: "BLUE_KILLED_BY_ME";
case RedKilledByMe: "RED_KILLED_BY_ME";
case YellowKilledByMe: "YELLOW_KILLED_BY_ME";
case GreenKilledByMe: "GREEN_KILLED_BY_ME";
case MyNumKilledByBlue: "MY_NUM_KILLED_BY_BLUE";
case MyNumKilledByRed: "MY_NUM_KILLED_BY_RED";
case MyNumKilledByYellow: "MY_NUM_KILLED_BY_YELLOW";
case MyNumKilledByGreen: "MY_NUM_KILLED_BY_GREEN";
case Burn: "BURN";
case Blast: "BLAST";
case LightningBolt: "LIGHTNING_BOLT";
case Whirlwind: "WHIRLWIND";
case InsectPlague: "INSECT_PLAGUE";
case Invisibility: "INVISIBILITY";
case Hypnotism: "HYPNOTISM";
case Firestorm: "FIRESTORM";
case GhostArmy: "GHOST_ARMY";
case Erosion: "EROSION";
case Swamp: "SWAMP";
case LandBridge: "LAND_BRIDGE";
case AngelOfDead: "ANGEL_OF_DEAD";
case Earthquake: "EARTHQUAKE";
case Flatten: "FLATTEN";
case Volcano: "VOLCANO";
case WrathOfGod: "WRATH_OF_GOD";
case Brave: "BRAVE";
case Warrior: "WARRIOR";
case Religious: "RELIGIOUS";
case Spy: "SPY";
case Firewarrior: "FIREWARRIOR";
case Shaman: "SHAMAN";
case SmallHut: "SMALL_HUT";
case MediumHut: "MEDIUM_HUT";
case LargeHut: "LARGE_HUT";
case DrumTower: "DRUM_TOWER";
case Temple: "TEMPLE";
case SpyTrain: "SPY_TRAIN";
case WarriorTrain: "WARRIOR_TRAIN";
case FirewarriorTrain: "FIREWARRIOR_TRAIN";
case Reconversion: "RECONVERSION";
case WallPiece: "WALL_PIECE";
case Gate: "GATE";
case BoatHut: "BOAT_HUT";
case BoatHut2: "BOAT_HUT_2";
case AirshipHut: "AIRSHIP_HUT";
case AirshipHut2: "AIRSHIP_HUT_2";
case NoSpecificPerson: "NO_SPECIFIC_PERSON";
case NoSpecificBuilding: "NO_SPECIFIC_BUILDING";
case NoSpecificSpell: "NO_SPECIFIC_SPELL";
case TargetShaman: "TARGET_SHAMAN";
case MyVehicleBoat1: "MY_VEHICLE_BOAT_1";
case MyVehicleAirship1: "MY_VEHICLE_AIRSHIP_1";
case BlueVehicleBoat1: "BLUE_VEHICLE_BOAT_1";
case BlueVehicleAirship1: "BLUE_VEHICLE_AIRSHIP_1";
case RedVehicleBoat1: "RED_VEHICLE_BOAT_1";
case RedVehicleAirship1: "RED_VEHICLE_AIRSHIP_1";
case YellowVehicleBoat1: "YELLOW_VEHICLE_BOAT_1";
case YellowVehicleAirship1: "YELLOW_VEHICLE_AIRSHIP_1";
case GreenVehicleBoat1: "GREEN_VEHICLE_BOAT_1";
case GreenVehicleAirship1: "GREEN_VEHICLE_AIRSHIP_1";
case CpFreeEntries: "CP_FREE_ENTRIES";
case Random100: "RANDOM_100";
case NumShamenDefenders: "NUM_SHAMEN_DEFENDERS";
case CameraAngle: "CAMERA_ANGLE";
case CameraX: "CAMERA_X";
case CameraZ: "CAMERA_Z";
case MySpellShieldCost: "MY_SPELL_SHIELD_COST";
case Shield: "SHIELD";
case Convert: "CONVERT";
case Teleport: "TELEPORT";
case Bloodlust: "BLOODLUST";
