case if: "if";
case else: "else";
case null: "null";
case null: "null";
case null: "null";
case every: "every";
case null: "null";
case set: "set";
case inc: "inc";
case dec: "dec";
case exp_start: "exp_start";
case exp_end: "exp_end";
case >: ">";
case <: "<";
case ==: "==";
case !=: "!=";
case >=: ">=";
case >=: ">=";
case null: "null";
case &&: "&&";
case ||: "||";
case on: "on";
case off: "off";
case computer_player: "computer_player";
case mul: "mul";
case div: "div";
case ConstructBuilding: "ConstructBuilding";
case FetchWood: "FetchWood";
case EnableShamanGetWilds: "EnableShamanGetWilds";
case HouseAPerson: "HouseAPerson";
case SendGhosts: "SendGhosts";
case BringNewPeopleBack: "BringNewPeopleBack";
case TrainPeople: "TrainPeople";
case PopulateDrumTower: "PopulateDrumTower";
case Defend: "Defend";
case DefendBase: "DefendBase";
case SpellDefence: "SpellDefence";
case Preach: "Preach";
case BuildWalls: "BuildWalls";
case Sabotage: "Sabotage";
case SpellOffensive: "SpellOffensive";
case FirewarriorDefend: "FirewarriorDefend";
case BuildVehicle: "BuildVehicle";
case FetchLostPeople: "FetchLostPeople";
case FetchLostVehicle: "FetchLostVehicle";
case FetchFarVehicle: "FetchFarVehicle";
case AutoAttack: "AutoAttack";
case ShamanDefend: "ShamanDefend";
case FlattenBase: "FlattenBase";
case BuildOuterDefences: "BuildOuterDefences";
case Spare5: "Spare5";
case Spare6: "Spare6";
case Spare7: "Spare7";
case Spare8: "Spare8";
case Spare9: "Spare9";
case Spare10: "Spare10";
case COUNT_WILD: "COUNT_WILD";
case Attack: "Attack";
case AttackBlue: "AttackBlue";
case AttackRed: "AttackRed";
case AttackYellow: "AttackYellow";
case AttackGreen: "AttackGreen";
case SpellAttack: "SpellAttack";
case ResetBaseMarker: "ResetBaseMarker";
case SetBaseMarker: "SetBaseMarker";
case SetBaseRadious: "SetBaseRadious";
case CountPeopleInMarker: "CountPeopleInMarker";
case SetDrumTowerPos: "SetDrumTowerPos";
case ATTACK_MARKER: "ATTACK_MARKER";
case ATTACK_BUILDING: "ATTACK_BUILDING";
case ATTACK_PERSON: "ATTACK_PERSON";
case ConvertAtMarker: "ConvertAtMarker";
case PreachAtMarker: "PreachAtMarker";
case SendGhostPeople: "SendGhostPeople";
case GetSpellsCast: "GetSpellsCast";
case GetNumOneOffSpells: "GetNumOneOffSpells";
case ATTACK_NORMAL: "ATTACK_NORMAL";
case ATTACK_BY_BOAT: "ATTACK_BY_BOAT";
case ATTACK_BY_BALLON: "ATTACK_BY_BALLON";
case SetAttackVariable: "SetAttackVariable";
case BuildDrumTower: "BuildDrumTower";
case GuardAtMarker: "GuardAtMarker";
case GuardBetweenMarkers: "GuardBetweenMarkers";
case GetHeightAtPos: "GetHeightAtPos";
case SendAllPeopleToMarker: "SendAllPeopleToMarker";
case GUARD_NORMAL: "GUARD_NORMAL";
case GUARD_WITH_GHOSTS: "GUARD_WITH_GHOSTS";
case ResetConvertMarker: "ResetConvertMarker";
case SetConvertMarker: "SetConvertMarker";
case SetMarkerEntry: "SetMarkerEntry";
case MarkerEntries: "MarkerEntries";
case ClearGuardingFrom: "ClearGuardingFrom";
case SetBuildingDirection: "SetBuildingDirection";
case TrainPeopleNow: "TrainPeopleNow";
case PrayAtHead: "PrayAtHead";
case PutPersonInDrumTower: "PutPersonInDrumTower";
case IHaveOneShot: "IHaveOneShot";
case SPELL_TYPE: "SPELL_TYPE";
case BUILDING_TYPE: "BUILDING_TYPE";
case BoatPatrol: "BoatPatrol";
case DefendShamen: "DefendShamen";
case SendShamenDefendersHome: "SendShamenDefendersHome";
case BOAT_TYPE: "BOAT_TYPE";
case BALLON_TYPE: "BALLON_TYPE";
case IsBuildingNear: "IsBuildingNear";
case BuildAt: "BuildAt";
case SetSpellEntry: "SetSpellEntry";
case DelayMainDrumTower: "DelayMainDrumTower";
case BuildMainDrumTower: "BuildMainDrumTower";
case ZoomTo: "ZoomTo";
case DisableUserInputs: "DisableUserInputs";
case EnableUserInputs: "EnableUserInputs";
case OpenDialog: "OpenDialog";
case GiveOneShot: "GiveOneShot";
case ClearStandingPeople: "ClearStandingPeople";
case OnlyStandAtMarkers: "OnlyStandAtMarkers";
case TRIBE_BLUE: "TRIBE_BLUE";
case TRIBE_RED: "TRIBE_RED";
case TRIBE_YELLOW: "TRIBE_YELLOW";
case TRIBE_GREEN: "TRIBE_GREEN";
case NavCheck: "NavCheck";
case TargetsFirewarriors: "TargetsFirewarriors";
case DontTargetFirewarriors: "DontTargetFirewarriors";
case TargetBlueShaman: "TargetBlueShaman";
case DontTargetBlueShaman: "DontTargetBlueShaman";
case TargetBlueDrumTowers: "TargetBlueDrumTowers";
case DontTargetBlueDrumTowers: "DontTargetBlueDrumTowers";
case HasBlueKilledAGhost: "HasBlueKilledAGhost";
case CountGuardFires: "CountGuardFires";
case GetHeadTriggerCount: "GetHeadTriggerCount";
case MoveShamanToMarker: "MoveShamanToMarker";
case TrackShamanToAngle: "TrackShamanToAngle";
case TrackShamanExtraBollocks: "TrackShamanExtraBollocks";
case IsShamanAvailableForAttack: "IsShamanAvailableForAttack";
case PartialBuildingCount: "PartialBuildingCount";
case SendBluePeopleToMarker: "SendBluePeopleToMarker";
case GiveManaToPlayer: "GiveManaToPlayer";
case IsPlayerInWorldView: "IsPlayerInWorldView";
case SetAutoBuild: "SetAutoBuild";
case DeselectAllBluePeople: "DeselectAllBluePeople";
case FlashButton: "FlashButton";
case TurnPanelOn: "TurnPanelOn";
case GivePlayerSpell: "GivePlayerSpell";
case HasPlayerBeenInEncyc: "HasPlayerBeenInEncyc";
case IsBlueShamanSelected: "IsBlueShamanSelected";
case ClearShamanLeftClick: "ClearShamanLeftClick";
case ClearShamanRightClick: "ClearShamanRightClick";
case IsShamanIconLeftClicked: "IsShamanIconLeftClicked";
case IsShamanIconRightClicked: "IsShamanIconRightClicked";
case TriggerThing: "TriggerThing";
case TrackToMarker: "TrackToMarker";
case CameraRotation: "CameraRotation";
case StopCameraRotation: "StopCameraRotation";
case CountBlueShapes: "CountBlueShapes";
case CountBlueInHouses: "CountBlueInHouses";
case HasHouseInfoBeenShown: "HasHouseInfoBeenShown";
case ClearHouseInfoFlag: "ClearHouseInfoFlag";
case SetAutoHouse: "SetAutoHouse";
case CountBlueWithBuildCommand: "CountBlueWithBuildCommand";
case DontHouseSpecialists: "DontHouseSpecialists";
case TargetPlayerDrumTowerAndFirewarrior: "TargetPlayerDrumTowerAndFirewarrior";
case RemovePlayerThing: "RemovePlayerThing";
case SetReincarnation: "SetReincarnation";
case ExtraWoodCollection: "ExtraWoodCollection";
case SetWoodCollectionRadii: "SetWoodCollectionRadii";
case GetNumPeopleConverted: "GetNumPeopleConverted";
case GetNumPeopleBeingPreached: "GetNumPeopleBeingPreached";
case TriggerLevelLost: "TriggerLevelLost";
case TriggerLevelWon: "TriggerLevelWon";
case RemoveHeadAtPos: "RemoveHeadAtPos";
case SetBucketUsage: "SetBucketUsage";
case SetBucketCountForSpell: "SetBucketCountForSpell";
case CreateMsgNarrative: "CreateMsgNarrative";
case CreateMsgObjective: "CreateMsgObjective";
case CreateMsgInformation: "CreateMsgInformation";
case CreateMsgInformationZoom: "CreateMsgInformationZoom";
case SetMsgZoom: "SetMsgZoom";
case SetMsgTimeout: "SetMsgTimeout";
case SetMsgDeleteOnOk: "SetMsgDeleteOnOk";
case SetMsgReturnOnOk: "SetMsgReturnOnOk";
case SetMsgDeleteOnRmbZoom: "SetMsgDeleteOnRmbZoom";
case SetMsgOpenDlgOnRmbZoom: "SetMsgOpenDlgOnRmbZoom";
case SetCreateReturnMsgOnRmbZoom: "SetCreateReturnMsgOnRmbZoom";
case SetMsgOpenDlgOnRmbDelete: "SetMsgOpenDlgOnRmbDelete";
case SetMsgZoomOnLmbOpenDlg: "SetMsgZoomOnLmbOpenDlg";
case SetMsgAutoOpenDlg: "SetMsgAutoOpenDlg";
case SetSpecialNoBldgPanel: "SetSpecialNoBldgPanel";
case SetMsgOkSaveExitDlg: "SetMsgOkSaveExitDlg";
case FixWildInArea: "FixWildInArea";
case CheckIfPersonPreachedTo: "CheckIfPersonPreachedTo";
case CountAngels: "CountAngels";
case SetNoBlueReinc: "SetNoBlueReinc";
case IsShamanInArea: "IsShamanInArea";
case ForceTooltip: "ForceTooltip";
case SetDefenseRadius: "SetDefenseRadius";
case MarvellousHouseDeath: "MarvellousHouseDeath";
case CallToArms: "CallToArms";
case DeleteSmokeStuff: "DeleteSmokeStuff";
case SetTimerGoing: "SetTimerGoing";
case RemoveTimer: "RemoveTimer";
case HasTimerReachedZero: "HasTimerReachedZero";
case StartReincNow: "StartReincNow";
case TurnPush: "TurnPush";
case FlybyCreateNew: "FlybyCreateNew";
case FlybyStart: "FlybyStart";
case FlybyStop: "FlybyStop";
case FlybyAllowInterrupt: "FlybyAllowInterrupt";
case FlybySetEventPos: "FlybySetEventPos";
case FlybySetEventAngle: "FlybySetEventAngle";
case FlybySetEventZoom: "FlybySetEventZoom";
case FlybySetEventIntPoint: "FlybySetEventIntPoint";
case FlybySetEventTooltip: "FlybySetEventTooltip";
case FlybySetEndTarget: "FlybySetEndTarget";
case FlybySetMessage: "FlybySetMessage";
case KillTeamInArea: "KillTeamInArea";
case ClearAllMsg: "ClearAllMsg";
case SetMsgId: "SetMsgId";
case GetMsgId: "GetMsgId";
case KillAllMsgId: "KillAllMsgId";
case GiveUpAndSulk: "GiveUpAndSulk";
case AutoMessages: "AutoMessages";
case IsPrisonOnLevel: "IsPrisonOnLevel";
